#######
#     #
# @   #
#     #
#     #  F
#     #
#######
